- - - t - -
- - - - - -
- m m - t -
- - - - t -
- t - - - -
- t - m m -
- - - - - -
- - t - - -